R 1920 1080

NO
SO
WE
EA

F
C

333333333333333333333334
300000000000000030000004
301000000000000000000004
302000000000000000000004
302000000000000030000004
303000033333333333033334
303000030303030330003331
303000030000000330000004
303000000000000000003331
301000030000000330000004
300000030000000330003331
300000033330333333333331
333333333330333333333333
100000000000000000000004
333333033330333333333333
333333033330322222222223
300000000330320000020002
300000000000320030020002
300000000330320000022022
303030000330000030000002
300300000330320000022022
303030000330320030020002
300000000330320000020002
333333333311122222222223