R 1024 480

NO textures/eagle.xpm
SO textures/redbrick.xpm
WE textures/purplestone.xpm
EA textures/greystone.xpm

S textures/barrel.xpm

F 223, 255, 71
C 53, 80, 71


         111111111 111111111111111
         100100001 100000000000001
         1111000011000000000000001
        1000000010000010100000001
11111 11100000000000001N100000001
10001 100002000000000011100001111
100011111002000111111100000001
1000100000020001     100000001
1000100010000001 111 100000001
1000000000000001 1011100000001
1000001010000001 1000000000001
11000101 1010101 1111011110101
11110111 1110121 101111010001
11111111 1111111 111111111111


