R 601 380

NO textures/eagle.xpm
SO textures/redbrick.xpm
WE textures/purplestone.xpm
EA textures/greystone.xpm

S textures/barrel.xpm

F 255, 255, 255
C 53, 80, 71


         111111111 11111 111111111
         100100001 10001 100000001
         100100001 10001 111111111
         11110000110000111000000001
        100000001000001 0000000011
11111 11100000000000000W100000001
10001 10002220000000001110000111111
100011111022200111111100000001    1
1000100000222001     1000000011111
1000100010000001     100000001
1000000000000001 1111100000001
1000001010000001 1000000000001
11000101 1111111 1111011110101
11110111         101111010001
11111111         111111111111


