R 640 480

NO textures/eagle.xpm
SO textures/redbrick.xpm
WE textures/purplestone.xpm
EA textures/greystone.xpm

S textures/barrel.xpm

F 2, 255, 171
C 253,180,171


        111111111 111111111111111
        100000001 100000000000001
        1100000011100000000000001
        1000000000000000000000001
111111111000000000000000000000001
100000000000000000000000000001111
10000000000000E111111100000001
1000000000000001     100000001
1000000000000001 111 100000001
1000000000000001 1011100000001
1000000000000001 1000000000001
1100000111010101 1111011110101
11110111 1110121 101111010001
11111111 1111111 111111111111


