R 1920 1080

NO
SO
WE
EA

F
C

       111111111111111111111111
      100000000000000010000001
     101000000000000000000001
    101000000000000000000001
   101000000000000010000001
  101000011111111111011111
 101000010101010110001111
101000010000000110000001
1010000000000000100011111
1010000100000001 10000001
1000000100000001 10001111
100000011110111111111111
111111111110111111111111
100000000000000000000001
111111011110111111111111
111111011110111111111111
100000000110110000010001
100000000000110010010001
100000000110110000011011
101010000110000010000001
100100000110110000011011
101010000110110010010001
100000000110110000010001
111111111111111111111111